11111111
100C0CE1
1PC0C001
11111111