11111111
1P0C0CE1
10000001
10000001
100C0C01
11111111