11111111
1P0C0CE1
10C0C001
11111111