1111111111111111111
1E0000000000000C001
1010010100100000101
1010010100100000101
1010010100100000101
101P010100100000101
1010010100100000101
1010010100100000101
1111111111111111111